NO ./Textures/Brick.xpm
SO ./Textures/Grass.xpm
WE ./Textures/Pipes.xpm
EA ./Textures/Wood.xpm

 F 164,135,114
C 149,212,255

1111111111111111111111111
100000001011000000000000 
101100000111000000N000001
1001000000000000000000001
1111111110110000011100001111111
100000000011000001110111111111111
11110111111111011100000011111
1111011111111101110101001
110000001101010111000000111111
100000000000000110000001000011111
1000000000000000110101000000110001
1100000111010101111101000000000001
11110111 1110101 10111100000100001
11111111 1111111 11111111111111111
